ACCTCCCCTTGCTCCTTCCA -> CCTCCCCTTGCTCCTTCCAG
TCCAACTCGATGGGTTATTA -> CCAACTCGATGGGTTATTAA
TCGTGTGGAGTGCTGGTAAG -> CGTGTGGAGTGCTGGTAAGT
ATCCTTGTGGAGTTTTCATC -> TCCTTGTGGAGTTTTCATCC
AGGGTCCTCTACGTATACGA -> GGGTCCTCTACGTATACGAG
GCTTGCTCGGGTGACACCTT -> CTTGCTCGGGTGACACCTTC
CTCTCGGTCCGCTTGAGACT -> TCTCGGTCCGCTTGAGACTT
CTCTTCTTAAAAAGATTTGT -> TCTTCTTAAAAAGATTTGTC
TGCTCGGGTGACACCTTCTC -> GCTCGGGTGACACCTTCTCT
TTGTACGAGAGTGTGTCCCG -> TGTACGAGAGTGTGTCCCGC
GAAGGCTATTCTCCATGTCC -> AAGGCTATTCTCCATGTCCG
AGGAACAATTCGACTCGCCT -> GGAACAATTCGACTCGCCTA
TATACATCCCTAACTGGCTG -> ATACATCCCTAACTGGCTGG
GACACGACCTATCCTTGTGG -> ACACGACCTATCCTTGTGGA
TCCATGTCCGGGTTTTGTCC -> CCATGTCCGGGTTTTGTCCT
CTATTCTCCATGTCCGGGTT -> TATTCTCCATGTCCGGGTTT
CATCAGAGTGGTCAAAGGGG -> ATCAGAGTGGTCAAAGGGGT
GCATTCTGTCGAGTATTGCC -> CATTCTGTCGAGTATTGCCT
GCATACCTAGCCTTGCCTTG -> CATACCTAGCCTTGCCTTGG
TCCCGTTATCGATCTGAGTC -> CCCGTTATCGATCTGAGTCT
AGAGGAAGCCGTGGTGGCGA -> GAGGAAGCCGTGGTGGCGAG
CCGGAAATGGCCATCACGCT -> CGGAAATGGCCATCACGCTG
CTAACTGGCTGGGGAGTCCT -> TAACTGGCTGGGGAGTCCTG
TCACGCTGGATATAGACATA -> CACGCTGGATATAGACATAC
CTCTTCGTGTGGAGTGCTGG -> TCTTCGTGTGGAGTGCTGGT
ATATGCGGAGAGAGCTCGAT -> TATGCGGAGAGAGCTCGATC
TTCTCCATGTCCGGGTTTTG -> TCTCCATGTCCGGGTTTTGT
GCGACCATCCCGTTATCGAT -> CGACCATCCCGTTATCGATC
GGGGACGCCTTGTGAAGCAT -> GGGACGCCTTGTGAAGCATA
CGTGTGGAGTGCTGGTAAGT -> GTGTGGAGTGCTGGTAAGTC
AATCCTAACATACCGTGCCG -> ATCCTAACATACCGTGCCGG
TAGGCGGGAGGAACAATTCG -> AGGCGGGAGGAACAATTCGA
TCTGACACGACCTATCCTTG -> CTGACACGACCTATCCTTGT
ATCCCTAACTGGCTGGGGAG -> TCCCTAACTGGCTGGGGAGT
TGTTCTGTAAGCCCCAACTG -> GTTCTGTAAGCCCCAACTGC
GTGGCGAGCCGAGGATTAGA -> TGGCGAGCCGAGGATTAGAT
GAGTCTTCCAGCTCTTGCGG -> AGTCTTCCAGCTCTTGCGGC
TGACACGACCTATCCTTGTG -> GACACGACCTATCCTTGTGG
CTACGATCTATGCACTTGAA -> TACGATCTATGCACTTGAAA
CTGGGGAGTCCTGCATAACG -> TGGGGAGTCCTGCATAACGC
AGAGTGTGTCCCGCCTGTGA -> GAGTGTGTCCCGCCTGTGAT
CCCACCTTATACCCCGCATA -> CCACCTTATACCCCGCATAC
TGCCTGAGCCGCCTTTGGGC -> GCCTGAGCCGCCTTTGGGCG
CGAATATGCGGAGAGAGCTC -> GAATATGCGGAGAGAGCTCG
GGTCCGCTTGAGACTTCTGA -> GTCCGCTTGAGACTTCTGAC
ATACACCCCTCTGATAGCCC -> TACACCCCTCTGATAGCCCT
TGTCGAGTATTGCCTGAGCC -> GTCGAGTATTGCCTGAGCCG
ACGAAGTTCACGAATATGCG -> CGAAGTTCACGAATATGCGG
TGGGTTATTAACAGGGCCCC -> GGGTTATTAACAGGGCCCCC
TTCCAGCTCTTGCGGCTACG -> TCCAGCTCTTGCGGCTACGA
TCATAAGTTGTACTTACAAG -> CATAAGTTGTACTTACAAGC
TATATTGGTATATCTTTTTA -> ATATTGGTATATCTTTTTAA
GGCCATCACGCTGGATATAG -> GCCATCACGCTGGATATAGA
CTAACATACCGTGCCGGAAA -> TAACATACCGTGCCGGAAAT
GACACTAATCCTAACATACC -> ACACTAATCCTAACATACCG
ATCCTAACATACCGTGCCGG -> TCCTAACATACCGTGCCGGA
GCCTTCATCAGAGTGGTCAA -> CCTTCATCAGAGTGGTCAAA
GAGTTGTTCTGTAAGCCCCA -> AGTTGTTCTGTAAGCCCCAA
CGTCACTCAGGCGACGAGCG -> GTCACTCAGGCGACGAGCGA
ATCCCGTTATCGATCTGAGT -> TCCCGTTATCGATCTGAGTC
TACTAGCCCACCTTATACCC -> ACTAGCCCACCTTATACCCC
CGCCGTTCCTTTCCGACCAT -> GCCGTTCCTTTCCGACCATA
CGTTCCTTTCCGACCATATG -> GTTCCTTTCCGACCATATGG
ATGCGGAGAGAGCTCGATCC -> TGCGGAGAGAGCTCGATCCC
CTTGTGGAGTTTTCATCCAA -> TTGTGGAGTTTTCATCCAAC
ATATGGGATTGGTACTAGCC -> TATGGGATTGGTACTAGCCC
TACCTAGCCTTGCCTTGGAG -> ACCTAGCCTTGCCTTGGAGA
GGGTTGTACGAGAGTGTGTC -> GGTTGTACGAGAGTGTGTCC
AGTAAAACCTAGGCGGGAGG -> GTAAAACCTAGGCGGGAGGA
CTTGAGACTTCTGACACGAC -> TTGAGACTTCTGACACGACC
GAATCGTATACATCCCTAAC -> AATCGTATACATCCCTAACT
CTTCATAAGTTGTACTTACA -> TTCATAAGTTGTACTTACAA
CGTCGAGCCTTCATCAGAGT -> GTCGAGCCTTCATCAGAGTG
CTAGCCCACCTTATACCCCG -> TAGCCCACCTTATACCCCGC
ATTAACAGGGCCCCCCGTAG -> TTAACAGGGCCCCCCGTAGG
CTTAAAAAGATTTGTCATGA -> TTAAAAAGATTTGTCATGAA
TCTCGGTCCGCTTGAGACTT -> CTCGGTCCGCTTGAGACTTC
TATTGCCTGAGCCGCCTTTG -> ATTGCCTGAGCCGCCTTTGG
TTGGGCGCAACTCGCTTGAC -> TGGGCGCAACTCGCTTGACC
TGTGTCCCGCCTGTGATAGG -> GTGTCCCGCCTGTGATAGGT
ACCTCGCACTTCGTCGAGCC -> CCTCGCACTTCGTCGAGCCT
TAAGCCCCAACTGCAGGAAT -> AAGCCCCAACTGCAGGAATC
TGTGGAGTGCTGGTAAGTCT -> GTGGAGTGCTGGTAAGTCTG
GTAAGAGGAAGCCGTGGTGG -> TAAGAGGAAGCCGTGGTGGC
GCTCCTTCCAGTGCTCGCCG -> CTCCTTCCAGTGCTCGCCGT
GAGTGGTCAAAGGGGTAAGA -> AGTGGTCAAAGGGGTAAGAG
CCTTTTACGAGACCAGTAAA -> CTTTTACGAGACCAGTAAAA
ACTGGCTGGGGAGTCCTGCA -> CTGGCTGGGGAGTCCTGCAT
AAAGGGGTAAGAGGAAGCCG -> AAGGGGTAAGAGGAAGCCGT
TCTTCTTAAAAAGATTTGTC -> CTTCTTAAAAAGATTTGTCA
ATCCCGATAACTCTTCTTAA -> TCCCGATAACTCTTCTTAAA
GCACCCGAGCGGTACGAAGT -> CACCCGAGCGGTACGAAGTT
GAGAGCTCGATCCCGATAAC -> AGAGCTCGATCCCGATAACT
GTGAAGCATATACCTCCCCT -> TGAAGCATATACCTCCCCTT
TAACGCAACCTGCGTCACTC -> AACGCAACCTGCGTCACTCA
ATGCACTTGAAACTGCCAAC -> TGCACTTGAAACTGCCAACA
TTGCGGGAAGGCTATTCTCC -> TGCGGGAAGGCTATTCTCCA
CTTCTCTTCGTGTGGAGTGC -> TTCTCTTCGTGTGGAGTGCT
GCTGGGGAGTCCTGCATAAC -> CTGGGGAGTCCTGCATAACG
GCAACCTGCGTCACTCAGGC -> CAACCTGCGTCACTCAGGCG
TTCTGACACGACCTATCCTT -> TCTGACACGACCTATCCTTG
ACCAGTAAAACCTAGGCGGG -> CCAGTAAAACCTAGGCGGGA
CTGCAGGAATCGTATACATC -> TGCAGGAATCGTATACATCC
CCTTCTCTTCGTGTGGAGTG -> CTTCTCTTCGTGTGGAGTGC
AAGTTCACGAATATGCGGAG -> AGTTCACGAATATGCGGAGA
CACGACCTATCCTTGTGGAG -> ACGACCTATCCTTGTGGAGT
ATACCGTGCCGGAAATGGCC -> TACCGTGCCGGAAATGGCCA
GTACGAGAGTGTGTCCCGCC -> TACGAGAGTGTGTCCCGCCT
CAGGAATCGTATACATCCCT -> AGGAATCGTATACATCCCTA
AGTCCTGCATAACGCAACCT -> GTCCTGCATAACGCAACCTG
CCATCCCGTTATCGATCTGA -> CATCCCGTTATCGATCTGAG
CCGTGGTGGCGAGCCGAGGA -> CGTGGTGGCGAGCCGAGGAT
AATTCGACTCGCCTAGGCTC -> ATTCGACTCGCCTAGGCTCT
GGAATCGTATACATCCCTAA -> GAATCGTATACATCCCTAAC
TTAGACGGGCGGGGACGCCT -> TAGACGGGCGGGGACGCCTT
TCGGTCCGCTTGAGACTTCT -> CGGTCCGCTTGAGACTTCTG
AACTGGCTGGGGAGTCCTGC -> ACTGGCTGGGGAGTCCTGCA
ACAGGGCCCCCCGTAGGGTT -> CAGGGCCCCCCGTAGGGTTG
TCTATGCACTTGAAACTGCC -> CTATGCACTTGAAACTGCCA
TCCAGCTCTTGCGGCTACGA -> CCAGCTCTTGCGGCTACGAT
AGCGGTACGAAGTTCACGAA -> GCGGTACGAAGTTCACGAAT
AGGCTCTCGGTCCGCTTGAG -> GGCTCTCGGTCCGCTTGAGA
CGACCTATCCTTGTGGAGTT -> GACCTATCCTTGTGGAGTTT
CTCCTTCCAGTGCTCGCCGT -> TCCTTCCAGTGCTCGCCGTT
GAGCGAATCCACAATTTTAA -> AGCGAATCCACAATTTTAAC
GTACTAGCCCACCTTATACC -> TACTAGCCCACCTTATACCC
TAATCCTAACATACCGTGCC -> AATCCTAACATACCGTGCCG
ACTCGCTTGACCTTTTACGA -> CTCGCTTGACCTTTTACGAG
TCTGTCGAGTATTGCCTGAG -> CTGTCGAGTATTGCCTGAGC
CGACTCGCCTAGGCTCTCGG -> GACTCGCCTAGGCTCTCGGT
ATACCTAGCCTTGCCTTGGA -> TACCTAGCCTTGCCTTGGAG
TAACTCTTCTTAAAAAGATT -> AACTCTTCTTAAAAAGATTT
AATTACTTCTCACACTTTTG -> ATTACTTCTCACACTTTTGC
CCTTGTGGAGTTTTCATCCA -> CTTGTGGAGTTTTCATCCAA
TGATGTTTTGCATTCTGTCG -> GATGTTTTGCATTCTGTCGA
ATACCTCCCCTTGCTCCTTC -> TACCTCCCCTTGCTCCTTCC
AAACCTAGGCGGGAGGAACA -> AACCTAGGCGGGAGGAACAA
ACGCTGGATATAGACATACA -> CGCTGGATATAGACATACAC
CAGGGTCCTCTACGTATACG -> AGGGTCCTCTACGTATACGA
TATCGATCTGAGTCTTCCAG -> ATCGATCTGAGTCTTCCAGC
GAACAATTCGACTCGCCTAG -> AACAATTCGACTCGCCTAGG
GTCTTCCAGCTCTTGCGGCT -> TCTTCCAGCTCTTGCGGCTA
TGAGTCTTCCAGCTCTTGCG -> GAGTCTTCCAGCTCTTGCGG
AGGATTAGATTAGACGGGCG -> GGATTAGATTAGACGGGCGG
ATTACTTCTCACACTTTTGC -> TTACTTCTCACACTTTTGCA
TTTAACATGCTATATTGGTA -> TTAACATGCTATATTGGTAT
AGCGAATCCACAATTTTAAC -> GCGAATCCACAATTTTAACA
CGCTTGACCTTTTACGAGAC -> GCTTGACCTTTTACGAGACC
CTTGACCTTTTACGAGACCA -> TTGACCTTTTACGAGACCAG
ACGATCTATGCACTTGAAAC -> CGATCTATGCACTTGAAACT
ATGGCCATCACGCTGGATAT -> TGGCCATCACGCTGGATATA
TACGAGTTGTTCTGTAAGCC -> ACGAGTTGTTCTGTAAGCCC
ACCCCTCTGATAGCCCTTAC -> CCCCTCTGATAGCCCTTACT
CACTTCATAAGTTGTACTTA -> ACTTCATAAGTTGTACTTAC
AGGCGGGAGGAACAATTCGA -> GGCGGGAGGAACAATTCGAC
TAACTGGCTGGGGAGTCCTG -> AACTGGCTGGGGAGTCCTGC
GGCCCCCCGTAGGGTTGTAC -> GCCCCCCGTAGGGTTGTACG
GTGTGTCCCGCCTGTGATAG -> TGTGTCCCGCCTGTGATAGG
GGATTGGTACTAGCCCACCT -> GATTGGTACTAGCCCACCTT
CCTAGGCGGGAGGAACAATT -> CTAGGCGGGAGGAACAATTC
ACACCTTCTCTTCGTGTGGA -> CACCTTCTCTTCGTGTGGAG
GGGAAGGCTATTCTCCATGT -> GGAAGGCTATTCTCCATGTC
GGTCAAAGGGGTAAGAGGAA -> GTCAAAGGGGTAAGAGGAAG
GCCGGAAATGGCCATCACGC -> CCGGAAATGGCCATCACGCT
CCGAGCGGTACGAAGTTCAC -> CGAGCGGTACGAAGTTCACG
CACAATTTTAACATGCTATA -> ACAATTTTAACATGCTATAT
ATATTGGTATATCTTTTTAA -> TATTGGTATATCTTTTTAAT
TTTTAACATGCTATATTGGT -> TTTAACATGCTATATTGGTA
CCGCATACCTAGCCTTGCCT -> CGCATACCTAGCCTTGCCTT
GGTAAGAGGAAGCCGTGGTG -> GTAAGAGGAAGCCGTGGTGG
GGGTCCTCTACGTATACGAG -> GGTCCTCTACGTATACGAGT
TTCTCACACTTTTGCACCCG -> TCTCACACTTTTGCACCCGA
TCCTTTCCGACCATATGGGA -> CCTTTCCGACCATATGGGAT
GTTATCGATCTGAGTCTTCC -> TTATCGATCTGAGTCTTCCA
TTCTGTCGAGTATTGCCTGA -> TCTGTCGAGTATTGCCTGAG
ACTTTTGCACCCGAGCGGTA -> CTTTTGCACCCGAGCGGTAC
TCACGAATATGCGGAGAGAG -> CACGAATATGCGGAGAGAGC
CGGAGAGAGCTCGATCCCGA -> GGAGAGAGCTCGATCCCGAT
GAGATACTTGTCATTTCCAT -> AGATACTTGTCATTTCCATC
CCTGCGTCACTCAGGCGACG -> CTGCGTCACTCAGGCGACGA
AACATACCGTGCCGGAAATG -> ACATACCGTGCCGGAAATGG
GGTTGTACGAGAGTGTGTCC -> GTTGTACGAGAGTGTGTCCC
ACAATTTTAACATGCTATAT -> CAATTTTAACATGCTATATT
CAGTGCTCGCCGTTCCTTTC -> AGTGCTCGCCGTTCCTTTCC
AATCGTATACATCCCTAACT -> ATCGTATACATCCCTAACTG
TTTAATTACTTCTCACACTT -> TTAATTACTTCTCACACTTT
ATTCGACTCGCCTAGGCTCT -> TTCGACTCGCCTAGGCTCTC
ACTCGATGGGTTATTAACAG -> CTCGATGGGTTATTAACAGG
TCCACAATTTTAACATGCTA -> CCACAATTTTAACATGCTAT
GTTCCTTTCCGACCATATGG -> TTCCTTTCCGACCATATGGG
CCTTGCCTTGGAGATACTTG -> CTTGCCTTGGAGATACTTGT
GTGGTGGCGAGCCGAGGATT -> TGGTGGCGAGCCGAGGATTA
GCCGTGGTGGCGAGCCGAGG -> CCGTGGTGGCGAGCCGAGGA
CCCGTAGGGTTGTACGAGAG -> CCGTAGGGTTGTACGAGAGT
GCCTAGGCTCTCGGTCCGCT -> CCTAGGCTCTCGGTCCGCTT
ATCGATCTGAGTCTTCCAGC -> TCGATCTGAGTCTTCCAGCT
CCGCTTGAGACTTCTGACAC -> CGCTTGAGACTTCTGACACG
CTTCATCAGAGTGGTCAAAG -> TTCATCAGAGTGGTCAAAGG
ATTGGTATATCTTTTTAATT -> TTGGTATATCTTTTTAATTA
CGACCATATGGGATTGGTAC -> GACCATATGGGATTGGTACT
AACAATTCGACTCGCCTAGG -> ACAATTCGACTCGCCTAGGC
TGCCAACACTTCATAAGTTG -> GCCAACACTTCATAAGTTGT
TTTGTCATGAATATGCCGCT -> TTGTCATGAATATGCCGCTT
CATTGCGGGAAGGCTATTCT -> ATTGCGGGAAGGCTATTCTC
GCGGGAAGGCTATTCTCCAT -> CGGGAAGGCTATTCTCCATG
ACCTAGCCTTGCCTTGGAGA -> CCTAGCCTTGCCTTGGAGAT
ACTTGAAACTGCCAACACTT -> CTTGAAACTGCCAACACTTC
GATGGGTTATTAACAGGGCC -> ATGGGTTATTAACAGGGCCC
TCCTAACATACCGTGCCGGA -> CCTAACATACCGTGCCGGAA
CTTGTCATTTCCATCATGAA -> TTGTCATTTCCATCATGAAT
TGCTATATTGGTATATCTTT -> GCTATATTGGTATATCTTTT
GCCAGGGTCCTCTACGTATA -> CCAGGGTCCTCTACGTATAC
CGTTATCGATCTGAGTCTTC -> GTTATCGATCTGAGTCTTCC
GGGTAAGAGGAAGCCGTGGT -> GGTAAGAGGAAGCCGTGGTG
GCCGCTTGCTCGGGTGACAC -> CCGCTTGCTCGGGTGACACC
CACTAATCCTAACATACCGT -> ACTAATCCTAACATACCGTG
CCTCCTACCTCGCACTTCGT -> CTCCTACCTCGCACTTCGTC
ACACTAATCCTAACATACCG -> CACTAATCCTAACATACCGT
ATTAGATTAGACGGGCGGGG -> TTAGATTAGACGGGCGGGGA
CGTAGGGTTGTACGAGAGTG -> GTAGGGTTGTACGAGAGTGT
GTCATTTCCATCATGAATGA -> TCATTTCCATCATGAATGAT
GTGATAGGTAATGGAACAGC -> TGATAGGTAATGGAACAGCG
ATTGCGGGAAGGCTATTCTC -> TTGCGGGAAGGCTATTCTCC
AACATGCTATATTGGTATAT -> ACATGCTATATTGGTATATC
AGTGCTCGCCGTTCCTTTCC -> GTGCTCGCCGTTCCTTTCCG
CCTCCTCCTACCTCGCACTT -> CTCCTCCTACCTCGCACTTC
GCTTGACCTTTTACGAGACC -> CTTGACCTTTTACGAGACCA
TGCTCCTTCCAGTGCTCGCC -> GCTCCTTCCAGTGCTCGCCG
TCGAGTATTGCCTGAGCCGC -> CGAGTATTGCCTGAGCCGCC
GTAAAACCTAGGCGGGAGGA -> TAAAACCTAGGCGGGAGGAA
ACTGCCAACACTTCATAAGT -> CTGCCAACACTTCATAAGTT
GTTATTAACAGGGCCCCCCG -> TTATTAACAGGGCCCCCCGT
AACCTAGGCGGGAGGAACAA -> ACCTAGGCGGGAGGAACAAT
AGCCGTGGTGGCGAGCCGAG -> GCCGTGGTGGCGAGCCGAGG
CTTTCCGACCATATGGGATT -> TTTCCGACCATATGGGATTG
AAAGATTTGTCATGAATATG -> AAGATTTGTCATGAATATGC
CTTTTGCACCCGAGCGGTAC -> TTTTGCACCCGAGCGGTACG
ACGGGCGGGGACGCCTTGTG -> CGGGCGGGGACGCCTTGTGA
AGACTTCTGACACGACCTAT -> GACTTCTGACACGACCTATC
CTGCGTCACTCAGGCGACGA -> TGCGTCACTCAGGCGACGAG
CCTGAGCCGCCTTTGGGCGC -> CTGAGCCGCCTTTGGGCGCA
CACGCTGGATATAGACATAC -> ACGCTGGATATAGACATACA
CTTCTGACACGACCTATCCT -> TTCTGACACGACCTATCCTT
TTTCATCCAACTCGATGGGT -> TTCATCCAACTCGATGGGTT
TCATCCAACTCGATGGGTTA -> CATCCAACTCGATGGGTTAT
CTTGGAGATACTTGTCATTT -> TTGGAGATACTTGTCATTTC
GCGAATCCACAATTTTAACA -> CGAATCCACAATTTTAACAT
GCTCGCCGTTCCTTTCCGAC -> CTCGCCGTTCCTTTCCGACC
TTAGATTAGACGGGCGGGGA -> TAGATTAGACGGGCGGGGAC
AGTTGTTCTGTAAGCCCCAA -> GTTGTTCTGTAAGCCCCAAC
ATATACCTCCCCTTGCTCCT -> TATACCTCCCCTTGCTCCTT
TAAGTCTGACACTAATCCTA -> AAGTCTGACACTAATCCTAA
AGCGACCATCCCGTTATCGA -> GCGACCATCCCGTTATCGAT
ACATACCGTGCCGGAAATGG -> CATACCGTGCCGGAAATGGC
TATACCCCGCATACCTAGCC -> ATACCCCGCATACCTAGCCT
TTCATAAGTTGTACTTACAA -> TCATAAGTTGTACTTACAAG
TGGTGGCGAGCCGAGGATTA -> GGTGGCGAGCCGAGGATTAG
CGAAGTTCACGAATATGCGG -> GAAGTTCACGAATATGCGGA
CTATATTGGTATATCTTTTT -> TATATTGGTATATCTTTTTA
GTACGAAGTTCACGAATATG -> TACGAAGTTCACGAATATGC
TGCATAACGCAACCTGCGTC -> GCATAACGCAACCTGCGTCA
CTAGCCTTGCCTTGGAGATA -> TAGCCTTGCCTTGGAGATAC
ATCCACAATTTTAACATGCT -> TCCACAATTTTAACATGCTA
CTCGCCGTTCCTTTCCGACC -> TCGCCGTTCCTTTCCGACCA
CTTCCAGTGCTCGCCGTTCC -> TTCCAGTGCTCGCCGTTCCT
CAGGCGACGAGCGAATCCAC -> AGGCGACGAGCGAATCCACA
GGAAGGCTATTCTCCATGTC -> GAAGGCTATTCTCCATGTCC
TCTGAGTCTTCCAGCTCTTG -> CTGAGTCTTCCAGCTCTTGC
CCGTTCCTTTCCGACCATAT -> CGTTCCTTTCCGACCATATG
GTCAAAGGGGTAAGAGGAAG -> TCAAAGGGGTAAGAGGAAGC
CGGAAATGGCCATCACGCTG -> GGAAATGGCCATCACGCTGG
CGAGTATTGCCTGAGCCGCC -> GAGTATTGCCTGAGCCGCCT
CATCACGCTGGATATAGACA -> ATCACGCTGGATATAGACAT
TGACCTTTTACGAGACCAGT -> GACCTTTTACGAGACCAGTA
GAGACTTCTGACACGACCTA -> AGACTTCTGACACGACCTAT
ACCTTATACCCCGCATACCT -> CCTTATACCCCGCATACCTA
TGCCTTGGAGATACTTGTCA -> GCCTTGGAGATACTTGTCAT
TCGTCGAGCCTTCATCAGAG -> CGTCGAGCCTTCATCAGAGT
AGTTGTACTTACAAGCCAGG -> GTTGTACTTACAAGCCAGGG
TGTGAAGCATATACCTCCCC -> GTGAAGCATATACCTCCCCT
GGTAATGGAACAGCGACCAT -> GTAATGGAACAGCGACCATC
AACACTTCATAAGTTGTACT -> ACACTTCATAAGTTGTACTT
TATAGACATACACCCCTCTG -> ATAGACATACACCCCTCTGA
CGCTGGATATAGACATACAC -> GCTGGATATAGACATACACC
CCTTCCAGTGCTCGCCGTTC -> CTTCCAGTGCTCGCCGTTCC
GCCTGAGCCGCCTTTGGGCG -> CCTGAGCCGCCTTTGGGCGC
AGGCGACGAGCGAATCCACA -> GGCGACGAGCGAATCCACAA
ACTCAGGCGACGAGCGAATC -> CTCAGGCGACGAGCGAATCC
CCAACACTTCATAAGTTGTA -> CAACACTTCATAAGTTGTAC
ATGTCCGGGTTTTGTCCTCC -> TGTCCGGGTTTTGTCCTCCT
TGGGCGCAACTCGCTTGACC -> GGGCGCAACTCGCTTGACCT
GAGTTTTCATCCAACTCGAT -> AGTTTTCATCCAACTCGATG
ATATGCCGCTTGCTCGGGTG -> TATGCCGCTTGCTCGGGTGA
GATTTGTCATGAATATGCCG -> ATTTGTCATGAATATGCCGC
GGAGTCCTGCATAACGCAAC -> GAGTCCTGCATAACGCAACC
TTATCGATCTGAGTCTTCCA -> TATCGATCTGAGTCTTCCAG
TTGACCTTTTACGAGACCAG -> TGACCTTTTACGAGACCAGT
GCGCAACTCGCTTGACCTTT -> CGCAACTCGCTTGACCTTTT
ATGCCGCTTGCTCGGGTGAC -> TGCCGCTTGCTCGGGTGACA
TCCGACCATATGGGATTGGT -> CCGACCATATGGGATTGGTA
ACGCCTTGTGAAGCATATAC -> CGCCTTGTGAAGCATATACC
CTACGTATACGAGTTGTTCT -> TACGTATACGAGTTGTTCTG
TACTTACAAGCCAGGGTCCT -> ACTTACAAGCCAGGGTCCTC
GCTGGATATAGACATACACC -> CTGGATATAGACATACACCC
TGCTCGCCGTTCCTTTCCGA -> GCTCGCCGTTCCTTTCCGAC
AACTCGCTTGACCTTTTACG -> ACTCGCTTGACCTTTTACGA
GGTATATCTTTTTAATTACT -> GTATATCTTTTTAATTACTT
TTCATCAGAGTGGTCAAAGG -> TCATCAGAGTGGTCAAAGGG
TCTGTAAGCCCCAACTGCAG -> CTGTAAGCCCCAACTGCAGG
TTGCTCCTTCCAGTGCTCGC -> TGCTCCTTCCAGTGCTCGCC
GAAACTGCCAACACTTCATA -> AAACTGCCAACACTTCATAA
TCCTTGTGGAGTTTTCATCC -> CCTTGTGGAGTTTTCATCCA
GAATCCACAATTTTAACATG -> AATCCACAATTTTAACATGC
TTGGAGATACTTGTCATTTC -> TGGAGATACTTGTCATTTCC
CTCACACTTTTGCACCCGAG -> TCACACTTTTGCACCCGAGC
CCCCCCGTAGGGTTGTACGA -> CCCCCGTAGGGTTGTACGAG
AAGCATATACCTCCCCTTGC -> AGCATATACCTCCCCTTGCT
AGGAAGCCGTGGTGGCGAGC -> GGAAGCCGTGGTGGCGAGCC
TGAAACTGCCAACACTTCAT -> GAAACTGCCAACACTTCATA
CAGCGACCATCCCGTTATCG -> AGCGACCATCCCGTTATCGA
GAAGCATATACCTCCCCTTG -> AAGCATATACCTCCCCTTGC
TCGAGCCTTCATCAGAGTGG -> CGAGCCTTCATCAGAGTGGT
ACATGCTATATTGGTATATC -> CATGCTATATTGGTATATCT
GAGACCAGTAAAACCTAGGC -> AGACCAGTAAAACCTAGGCG
CGATCTATGCACTTGAAACT -> GATCTATGCACTTGAAACTG
AGCCTTCATCAGAGTGGTCA -> GCCTTCATCAGAGTGGTCAA
CCCCAACTGCAGGAATCGTA -> CCCAACTGCAGGAATCGTAT
CTCCCCTTGCTCCTTCCAGT -> TCCCCTTGCTCCTTCCAGTG
CACCTTCTCTTCGTGTGGAG -> ACCTTCTCTTCGTGTGGAGT
GGCTGGGGAGTCCTGCATAA -> GCTGGGGAGTCCTGCATAAC
CCACCTTATACCCCGCATAC -> CACCTTATACCCCGCATACC
CTGTCGAGTATTGCCTGAGC -> TGTCGAGTATTGCCTGAGCC
TCATCAGAGTGGTCAAAGGG -> CATCAGAGTGGTCAAAGGGG
TATTAACAGGGCCCCCCGTA -> ATTAACAGGGCCCCCCGTAG
CCTGTGATAGGTAATGGAAC -> CTGTGATAGGTAATGGAACA
TTAACATGCTATATTGGTAT -> TAACATGCTATATTGGTATA
GCCGAGGATTAGATTAGACG -> CCGAGGATTAGATTAGACGG
GATCTATGCACTTGAAACTG -> ATCTATGCACTTGAAACTGC
CTGGCTGGGGAGTCCTGCAT -> TGGCTGGGGAGTCCTGCATA
TCACACTTTTGCACCCGAGC -> CACACTTTTGCACCCGAGCG
GTGCCGGAAATGGCCATCAC -> TGCCGGAAATGGCCATCACG
GATAGGTAATGGAACAGCGA -> ATAGGTAATGGAACAGCGAC
TGACACCTTCTCTTCGTGTG -> GACACCTTCTCTTCGTGTGG
TCGTATACATCCCTAACTGG -> CGTATACATCCCTAACTGGC
GTCCGGGTTTTGTCCTCCTC -> TCCGGGTTTTGTCCTCCTCC
ACTCTTCTTAAAAAGATTTG -> CTCTTCTTAAAAAGATTTGT
CCCCCGTAGGGTTGTACGAG -> CCCCGTAGGGTTGTACGAGA
GCCGTTCCTTTCCGACCATA -> CCGTTCCTTTCCGACCATAT
ATCCAACTCGATGGGTTATT -> TCCAACTCGATGGGTTATTA
TGAATATGCCGCTTGCTCGG -> GAATATGCCGCTTGCTCGGG
GAGAGAGCTCGATCCCGATA -> AGAGAGCTCGATCCCGATAA
ACTTACAAGCCAGGGTCCTC -> CTTACAAGCCAGGGTCCTCT
GGGCGGGGACGCCTTGTGAA -> GGCGGGGACGCCTTGTGAAG
TTTTGTCCTCCTCCTACCTC -> TTTGTCCTCCTCCTACCTCG
CGAGGATTAGATTAGACGGG -> GAGGATTAGATTAGACGGGC
CTTCTTAAAAAGATTTGTCA -> TTCTTAAAAAGATTTGTCAT
TATCTTTTTAATTACTTCTC -> ATCTTTTTAATTACTTCTCA
GATCTGAGTCTTCCAGCTCT -> ATCTGAGTCTTCCAGCTCTT
ATCTATGCACTTGAAACTGC -> TCTATGCACTTGAAACTGCC
TCATGAATATGCCGCTTGCT -> CATGAATATGCCGCTTGCTC
AGACCAGTAAAACCTAGGCG -> GACCAGTAAAACCTAGGCGG
GAGGATTAGATTAGACGGGC -> AGGATTAGATTAGACGGGCG
ATCACGCTGGATATAGACAT -> TCACGCTGGATATAGACATA
CATGAATATGCCGCTTGCTC -> ATGAATATGCCGCTTGCTCG
TCCAGTGCTCGCCGTTCCTT -> CCAGTGCTCGCCGTTCCTTT
CTTCTCACACTTTTGCACCC -> TTCTCACACTTTTGCACCCG
ATTGCCTGAGCCGCCTTTGG -> TTGCCTGAGCCGCCTTTGGG
ATGAATATGCCGCTTGCTCG -> TGAATATGCCGCTTGCTCGG
TTACAAGCCAGGGTCCTCTA -> TACAAGCCAGGGTCCTCTAC
GTAATGGAACAGCGACCATC -> TAATGGAACAGCGACCATCC
CACTCAGGCGACGAGCGAAT -> ACTCAGGCGACGAGCGAATC
CCCCTTGCTCCTTCCAGTGC -> CCCTTGCTCCTTCCAGTGCT
TTGCACCCGAGCGGTACGAA -> TGCACCCGAGCGGTACGAAG
ATAGACATACACCCCTCTGA -> TAGACATACACCCCTCTGAT
GTTTTGTCCTCCTCCTACCT -> TTTTGTCCTCCTCCTACCTC
TGAAGCATATACCTCCCCTT -> GAAGCATATACCTCCCCTTG
CGCCTGTGATAGGTAATGGA -> GCCTGTGATAGGTAATGGAA
CTCTACGTATACGAGTTGTT -> TCTACGTATACGAGTTGTTC
CAGCTCTTGCGGCTACGATC -> AGCTCTTGCGGCTACGATCT
TCGCCGTTCCTTTCCGACCA -> CGCCGTTCCTTTCCGACCAT
AGACGGGCGGGGACGCCTTG -> GACGGGCGGGGACGCCTTGT
GCCTTGTGAAGCATATACCT -> CCTTGTGAAGCATATACCTC
GAGTGTGTCCCGCCTGTGAT -> AGTGTGTCCCGCCTGTGATA
AACTCTTCTTAAAAAGATTT -> ACTCTTCTTAAAAAGATTTG
AGTGTGTCCCGCCTGTGATA -> GTGTGTCCCGCCTGTGATAG
CTGTAAGCCCCAACTGCAGG -> TGTAAGCCCCAACTGCAGGA
TAGATTAGACGGGCGGGGAC -> AGATTAGACGGGCGGGGACG
CCCGCATACCTAGCCTTGCC -> CCGCATACCTAGCCTTGCCT
CTTCCAGCTCTTGCGGCTAC -> TTCCAGCTCTTGCGGCTACG
GCCCCAACTGCAGGAATCGT -> CCCCAACTGCAGGAATCGTA
TTTTTAATTACTTCTCACAC -> TTTTAATTACTTCTCACACT
TCATGAATGATGTTTTGCAT -> CATGAATGATGTTTTGCATT
TTTTGCATTCTGTCGAGTAT -> TTTGCATTCTGTCGAGTATT
AAGTCTGACACTAATCCTAA -> AGTCTGACACTAATCCTAAC
CCATATGGGATTGGTACTAG -> CATATGGGATTGGTACTAGC
CCCGTTATCGATCTGAGTCT -> CCGTTATCGATCTGAGTCTT
TCTTTTTAATTACTTCTCAC -> CTTTTTAATTACTTCTCACA
CGAGCCGAGGATTAGATTAG -> GAGCCGAGGATTAGATTAGA
TTCACGAATATGCGGAGAGA -> TCACGAATATGCGGAGAGAG
CCCCGCATACCTAGCCTTGC -> CCCGCATACCTAGCCTTGCC
GGCGGGAGGAACAATTCGAC -> GCGGGAGGAACAATTCGACT
ATACGAGTTGTTCTGTAAGC -> TACGAGTTGTTCTGTAAGCC
CGCAACTCGCTTGACCTTTT -> GCAACTCGCTTGACCTTTTA
CGAGCCTTCATCAGAGTGGT -> GAGCCTTCATCAGAGTGGTC
CTGACACGACCTATCCTTGT -> TGACACGACCTATCCTTGTG
ATGTTTTGCATTCTGTCGAG -> TGTTTTGCATTCTGTCGAGT
ATGATGTTTTGCATTCTGTC -> TGATGTTTTGCATTCTGTCG
CAACTCGCTTGACCTTTTAC -> AACTCGCTTGACCTTTTACG
CGCCTTGTGAAGCATATACC -> GCCTTGTGAAGCATATACCT
GTTGTACGAGAGTGTGTCCC -> TTGTACGAGAGTGTGTCCCG
GTGGTCAAAGGGGTAAGAGG -> TGGTCAAAGGGGTAAGAGGA
ACTCGCCTAGGCTCTCGGTC -> CTCGCCTAGGCTCTCGGTCC
GATACTTGTCATTTCCATCA -> ATACTTGTCATTTCCATCAT
AAGATTTGTCATGAATATGC -> AGATTTGTCATGAATATGCC
TCGACTCGCCTAGGCTCTCG -> CGACTCGCCTAGGCTCTCGG
CTAGGCGGGAGGAACAATTC -> TAGGCGGGAGGAACAATTCG
GTCCGCTTGAGACTTCTGAC -> TCCGCTTGAGACTTCTGACA
ACCATCCCGTTATCGATCTG -> CCATCCCGTTATCGATCTGA
AAGTTGTACTTACAAGCCAG -> AGTTGTACTTACAAGCCAGG
GGTGACACCTTCTCTTCGTG -> GTGACACCTTCTCTTCGTGT
GTTCTGTAAGCCCCAACTGC -> TTCTGTAAGCCCCAACTGCA
CAACTGCAGGAATCGTATAC -> AACTGCAGGAATCGTATACA
AGTCTTCCAGCTCTTGCGGC -> GTCTTCCAGCTCTTGCGGCT
CATATACCTCCCCTTGCTCC -> ATATACCTCCCCTTGCTCCT
GAATGATGTTTTGCATTCTG -> AATGATGTTTTGCATTCTGT
CCCGATAACTCTTCTTAAAA -> CCGATAACTCTTCTTAAAAA
TCCCTAACTGGCTGGGGAGT -> CCCTAACTGGCTGGGGAGTC
GTTGTTCTGTAAGCCCCAAC -> TTGTTCTGTAAGCCCCAACT
TTCATCCAACTCGATGGGTT -> TCATCCAACTCGATGGGTTA
GCGGGGACGCCTTGTGAAGC -> CGGGGACGCCTTGTGAAGCA
GCGGGAGGAACAATTCGACT -> CGGGAGGAACAATTCGACTC
TATCCTTGTGGAGTTTTCAT -> ATCCTTGTGGAGTTTTCATC
CGGTACGAAGTTCACGAATA -> GGTACGAAGTTCACGAATAT
TCCTCCTACCTCGCACTTCG -> CCTCCTACCTCGCACTTCGT
GGTACGAAGTTCACGAATAT -> GTACGAAGTTCACGAATATG
TTGTGGAGTTTTCATCCAAC -> TGTGGAGTTTTCATCCAACT
TCTCACACTTTTGCACCCGA -> CTCACACTTTTGCACCCGAG
TCACTCAGGCGACGAGCGAA -> CACTCAGGCGACGAGCGAAT
ACGAGAGTGTGTCCCGCCTG -> CGAGAGTGTGTCCCGCCTGT
CGAGACCAGTAAAACCTAGG -> GAGACCAGTAAAACCTAGGC
ATCGTATACATCCCTAACTG -> TCGTATACATCCCTAACTGG
AGAGAGCTCGATCCCGATAA -> GAGAGCTCGATCCCGATAAC
CAAAGGGGTAAGAGGAAGCC -> AAAGGGGTAAGAGGAAGCCG
TGCAGGAATCGTATACATCC -> GCAGGAATCGTATACATCCC
CCCTAACTGGCTGGGGAGTC -> CCTAACTGGCTGGGGAGTCC
ATAACGCAACCTGCGTCACT -> TAACGCAACCTGCGTCACTC
CAATTTTAACATGCTATATT -> AATTTTAACATGCTATATTG
TCTCCATGTCCGGGTTTTGT -> CTCCATGTCCGGGTTTTGTC
CCGATAACTCTTCTTAAAAA -> CGATAACTCTTCTTAAAAAG
CGTGGTGGCGAGCCGAGGAT -> GTGGTGGCGAGCCGAGGATT
ACGACCTATCCTTGTGGAGT -> CGACCTATCCTTGTGGAGTT
GGCGACGAGCGAATCCACAA -> GCGACGAGCGAATCCACAAT
CGCATACCTAGCCTTGCCTT -> GCATACCTAGCCTTGCCTTG
TTATTAACAGGGCCCCCCGT -> TATTAACAGGGCCCCCCGTA
TGTTTTGCATTCTGTCGAGT -> GTTTTGCATTCTGTCGAGTA
GGGGTAAGAGGAAGCCGTGG -> GGGTAAGAGGAAGCCGTGGT
CTACCTCGCACTTCGTCGAG -> TACCTCGCACTTCGTCGAGC
CCGGGTTTTGTCCTCCTCCT -> CGGGTTTTGTCCTCCTCCTA
CGAGAGTGTGTCCCGCCTGT -> GAGAGTGTGTCCCGCCTGTG
GCCAACACTTCATAAGTTGT -> CCAACACTTCATAAGTTGTA
ACTTCTGACACGACCTATCC -> CTTCTGACACGACCTATCCT
CTCGCCTAGGCTCTCGGTCC -> TCGCCTAGGCTCTCGGTCCG
AACAGGGCCCCCCGTAGGGT -> ACAGGGCCCCCCGTAGGGTT
GGGTTATTAACAGGGCCCCC -> GGTTATTAACAGGGCCCCCC
GTCGAGTATTGCCTGAGCCG -> TCGAGTATTGCCTGAGCCGC
GGCTATTCTCCATGTCCGGG -> GCTATTCTCCATGTCCGGGT
CACTTCGTCGAGCCTTCATC -> ACTTCGTCGAGCCTTCATCA
TGACACTAATCCTAACATAC -> GACACTAATCCTAACATACC
AGGAATCGTATACATCCCTA -> GGAATCGTATACATCCCTAA
CGATGGGTTATTAACAGGGC -> GATGGGTTATTAACAGGGCC
ATTCTGTCGAGTATTGCCTG -> TTCTGTCGAGTATTGCCTGA
CTCGGTCCGCTTGAGACTTC -> TCGGTCCGCTTGAGACTTCT
GAAGCCGTGGTGGCGAGCCG -> AAGCCGTGGTGGCGAGCCGA
GTCCTGCATAACGCAACCTG -> TCCTGCATAACGCAACCTGC
ACACTTCATAAGTTGTACTT -> CACTTCATAAGTTGTACTTA
TTTGTCCTCCTCCTACCTCG -> TTGTCCTCCTCCTACCTCGC
CTCGCACTTCGTCGAGCCTT -> TCGCACTTCGTCGAGCCTTC
TGGAGTGCTGGTAAGTCTGA -> GGAGTGCTGGTAAGTCTGAC
GCTATATTGGTATATCTTTT -> CTATATTGGTATATCTTTTT
TCGCTTGACCTTTTACGAGA -> CGCTTGACCTTTTACGAGAC
TTTTCATCCAACTCGATGGG -> TTTCATCCAACTCGATGGGT
GATAACTCTTCTTAAAAAGA -> ATAACTCTTCTTAAAAAGAT
TGCTGGTAAGTCTGACACTA -> GCTGGTAAGTCTGACACTAA
ACAAGCCAGGGTCCTCTACG -> CAAGCCAGGGTCCTCTACGT
GCAGGAATCGTATACATCCC -> CAGGAATCGTATACATCCCT
CTTGCTCCTTCCAGTGCTCG -> TTGCTCCTTCCAGTGCTCGC
GGCGGGGACGCCTTGTGAAG -> GCGGGGACGCCTTGTGAAGC
TACAAGCCAGGGTCCTCTAC -> ACAAGCCAGGGTCCTCTACG
ACTGCAGGAATCGTATACAT -> CTGCAGGAATCGTATACATC
ATGGGATTGGTACTAGCCCA -> TGGGATTGGTACTAGCCCAC
AGTGGTCAAAGGGGTAAGAG -> GTGGTCAAAGGGGTAAGAGG
CTTTTTAATTACTTCTCACA -> TTTTTAATTACTTCTCACAC
CGGGTTTTGTCCTCCTCCTA -> GGGTTTTGTCCTCCTCCTAC
CCCAACTGCAGGAATCGTAT -> CCAACTGCAGGAATCGTATA
GCGGAGAGAGCTCGATCCCG -> CGGAGAGAGCTCGATCCCGA
AATCCACAATTTTAACATGC -> ATCCACAATTTTAACATGCT
GTGTGGAGTGCTGGTAAGTC -> TGTGGAGTGCTGGTAAGTCT
AGACATACACCCCTCTGATA -> GACATACACCCCTCTGATAG
GAACAGCGACCATCCCGTTA -> AACAGCGACCATCCCGTTAT
TACGAGACCAGTAAAACCTA -> ACGAGACCAGTAAAACCTAG
GATCCCGATAACTCTTCTTA -> ATCCCGATAACTCTTCTTAA
AAGGGGTAAGAGGAAGCCGT -> AGGGGTAAGAGGAAGCCGTG
TCTTCCAGCTCTTGCGGCTA -> CTTCCAGCTCTTGCGGCTAC
AAAAAGATTTGTCATGAATA -> AAAAGATTTGTCATGAATAT
GACCATCCCGTTATCGATCT -> ACCATCCCGTTATCGATCTG
ATAAGTTGTACTTACAAGCC -> TAAGTTGTACTTACAAGCCA
GCCTTGCCTTGGAGATACTT -> CCTTGCCTTGGAGATACTTG
TTCCATCATGAATGATGTTT -> TCCATCATGAATGATGTTTT
TTTACGAGACCAGTAAAACC -> TTACGAGACCAGTAAAACCT
GCCTTTGGGCGCAACTCGCT -> CCTTTGGGCGCAACTCGCTT
CTGGTAAGTCTGACACTAAT -> TGGTAAGTCTGACACTAATC
AAGAGGAAGCCGTGGTGGCG -> AGAGGAAGCCGTGGTGGCGA
CGACCATCCCGTTATCGATC -> GACCATCCCGTTATCGATCT
CAACACTTCATAAGTTGTAC -> AACACTTCATAAGTTGTACT
CCTTCATCAGAGTGGTCAAA -> CTTCATCAGAGTGGTCAAAG
GTGACACCTTCTCTTCGTGT -> TGACACCTTCTCTTCGTGTG
TTCGTCGAGCCTTCATCAGA -> TCGTCGAGCCTTCATCAGAG
CGCCTAGGCTCTCGGTCCGC -> GCCTAGGCTCTCGGTCCGCT
GAGGAACAATTCGACTCGCC -> AGGAACAATTCGACTCGCCT
CTGCATAACGCAACCTGCGT -> TGCATAACGCAACCTGCGTC
ATACATCCCTAACTGGCTGG -> TACATCCCTAACTGGCTGGG
ACAATTCGACTCGCCTAGGC -> CAATTCGACTCGCCTAGGCT
AAAAGATTTGTCATGAATAT -> AAAGATTTGTCATGAATATG
GATATAGACATACACCCCTC -> ATATAGACATACACCCCTCT
ATTTTAACATGCTATATTGG -> TTTTAACATGCTATATTGGT
GCTACGATCTATGCACTTGA -> CTACGATCTATGCACTTGAA
GTTGTACTTACAAGCCAGGG -> TTGTACTTACAAGCCAGGGT
GCCCACCTTATACCCCGCAT -> CCCACCTTATACCCCGCATA
GGCTACGATCTATGCACTTG -> GCTACGATCTATGCACTTGA
TCCTACCTCGCACTTCGTCG -> CCTACCTCGCACTTCGTCGA
TGGCGAGCCGAGGATTAGAT -> GGCGAGCCGAGGATTAGATT
ATGGGTTATTAACAGGGCCC -> TGGGTTATTAACAGGGCCCC
AATATGCGGAGAGAGCTCGA -> ATATGCGGAGAGAGCTCGAT
ACTTCGTCGAGCCTTCATCA -> CTTCGTCGAGCCTTCATCAG
CCACAATTTTAACATGCTAT -> CACAATTTTAACATGCTATA
GCGAGCCGAGGATTAGATTA -> CGAGCCGAGGATTAGATTAG
TTGAGACTTCTGACACGACC -> TGAGACTTCTGACACGACCT
CTCTTGCGGCTACGATCTAT -> TCTTGCGGCTACGATCTATG
TTCTTAAAAAGATTTGTCAT -> TCTTAAAAAGATTTGTCATG
CCTAACATACCGTGCCGGAA -> CTAACATACCGTGCCGGAAA
TTACTTCTCACACTTTTGCA -> TACTTCTCACACTTTTGCAC
TTCTGTAAGCCCCAACTGCA -> TCTGTAAGCCCCAACTGCAG
TGTCATTTCCATCATGAATG -> GTCATTTCCATCATGAATGA
CGGGAAGGCTATTCTCCATG -> GGGAAGGCTATTCTCCATGT
TACGTATACGAGTTGTTCTG -> ACGTATACGAGTTGTTCTGT
TGCGGCTACGATCTATGCAC -> GCGGCTACGATCTATGCACT
GCGGCTACGATCTATGCACT -> CGGCTACGATCTATGCACTT
TACGAGAGTGTGTCCCGCCT -> ACGAGAGTGTGTCCCGCCTG
TGTGGAGTTTTCATCCAACT -> GTGGAGTTTTCATCCAACTC
GGGCCCCCCGTAGGGTTGTA -> GGCCCCCCGTAGGGTTGTAC
ACCCGAGCGGTACGAAGTTC -> CCCGAGCGGTACGAAGTTCA
GAGTCCTGCATAACGCAACC -> AGTCCTGCATAACGCAACCT
GCTGGTAAGTCTGACACTAA -> CTGGTAAGTCTGACACTAAT
CCGTAGGGTTGTACGAGAGT -> CGTAGGGTTGTACGAGAGTG
GACTCGCCTAGGCTCTCGGT -> ACTCGCCTAGGCTCTCGGTC
GTGCTCGCCGTTCCTTTCCG -> TGCTCGCCGTTCCTTTCCGA
CTTTTACGAGACCAGTAAAA -> TTTTACGAGACCAGTAAAAC
ACATTGCGGGAAGGCTATTC -> CATTGCGGGAAGGCTATTCT
AGCCGAGGATTAGATTAGAC -> GCCGAGGATTAGATTAGACG
CCAACTCGATGGGTTATTAA -> CAACTCGATGGGTTATTAAC
GACTTCTGACACGACCTATC -> ACTTCTGACACGACCTATCC
GCACTTCGTCGAGCCTTCAT -> CACTTCGTCGAGCCTTCATC
TGTCCGGGTTTTGTCCTCCT -> GTCCGGGTTTTGTCCTCCTC
ACACCCCTCTGATAGCCCTT -> CACCCCTCTGATAGCCCTTA
CTAATCCTAACATACCGTGC -> TAATCCTAACATACCGTGCC
ACATCCCTAACTGGCTGGGG -> CATCCCTAACTGGCTGGGGA
ATTTCCATCATGAATGATGT -> TTTCCATCATGAATGATGTT
GGCTCTCGGTCCGCTTGAGA -> GCTCTCGGTCCGCTTGAGAC
CTCGCTTGACCTTTTACGAG -> TCGCTTGACCTTTTACGAGA
GTAGGGTTGTACGAGAGTGT -> TAGGGTTGTACGAGAGTGTG
TTAACAGGGCCCCCCGTAGG -> TAACAGGGCCCCCCGTAGGG
CATCCAACTCGATGGGTTAT -> ATCCAACTCGATGGGTTATT
CAATTCGACTCGCCTAGGCT -> AATTCGACTCGCCTAGGCTC
TGTGATAGGTAATGGAACAG -> GTGATAGGTAATGGAACAGC
CGGGAGGAACAATTCGACTC -> GGGAGGAACAATTCGACTCG
TGGTACTAGCCCACCTTATA -> GGTACTAGCCCACCTTATAC
TCTTAAAAAGATTTGTCATG -> CTTAAAAAGATTTGTCATGA
GGATTAGATTAGACGGGCGG -> GATTAGATTAGACGGGCGGG
CTGTGATAGGTAATGGAACA -> TGTGATAGGTAATGGAACAG
GTGCTGGTAAGTCTGACACT -> TGCTGGTAAGTCTGACACTA
GGAAGCCGTGGTGGCGAGCC -> GAAGCCGTGGTGGCGAGCCG
GCCCCCCGTAGGGTTGTACG -> CCCCCCGTAGGGTTGTACGA
CCGACCATATGGGATTGGTA -> CGACCATATGGGATTGGTAC
CATGCTATATTGGTATATCT -> ATGCTATATTGGTATATCTT
TCCTCTACGTATACGAGTTG -> CCTCTACGTATACGAGTTGT
AGTATTGCCTGAGCCGCCTT -> GTATTGCCTGAGCCGCCTTT
GACGCCTTGTGAAGCATATA -> ACGCCTTGTGAAGCATATAC
AGTCTGACACTAATCCTAAC -> GTCTGACACTAATCCTAACA
GAATATGCCGCTTGCTCGGG -> AATATGCCGCTTGCTCGGGT
CCCTTGCTCCTTCCAGTGCT -> CCTTGCTCCTTCCAGTGCTC
GTACTTACAAGCCAGGGTCC -> TACTTACAAGCCAGGGTCCT
TCTTGCGGCTACGATCTATG -> CTTGCGGCTACGATCTATGC
CGTATACATCCCTAACTGGC -> GTATACATCCCTAACTGGCT
CTGAGTCTTCCAGCTCTTGC -> TGAGTCTTCCAGCTCTTGCG
CCTTTCCGACCATATGGGAT -> CTTTCCGACCATATGGGATT
GTTCACGAATATGCGGAGAG -> TTCACGAATATGCGGAGAGA
GGAACAGCGACCATCCCGTT -> GAACAGCGACCATCCCGTTA
GACACCTTCTCTTCGTGTGG -> ACACCTTCTCTTCGTGTGGA
AGGGCCCCCCGTAGGGTTGT -> GGGCCCCCCGTAGGGTTGTA
TCCTGCATAACGCAACCTGC -> CCTGCATAACGCAACCTGCG
CGCTTGAGACTTCTGACACG -> GCTTGAGACTTCTGACACGA
CGAGTTGTTCTGTAAGCCCC -> GAGTTGTTCTGTAAGCCCCA
GGCGCAACTCGCTTGACCTT -> GCGCAACTCGCTTGACCTTT
ACGCAACCTGCGTCACTCAG -> CGCAACCTGCGTCACTCAGG
ACTAATCCTAACATACCGTG -> CTAATCCTAACATACCGTGC
GGTTTTGTCCTCCTCCTACC -> GTTTTGTCCTCCTCCTACCT
TGGCCATCACGCTGGATATA -> GGCCATCACGCTGGATATAG
CACTTTTGCACCCGAGCGGT -> ACTTTTGCACCCGAGCGGTA
AATGATGTTTTGCATTCTGT -> ATGATGTTTTGCATTCTGTC
CCTCCCCTTGCTCCTTCCAG -> CTCCCCTTGCTCCTTCCAGT
TGCGGAGAGAGCTCGATCCC -> GCGGAGAGAGCTCGATCCCG
AACTGCCAACACTTCATAAG -> ACTGCCAACACTTCATAAGT
TACATCCCTAACTGGCTGGG -> ACATCCCTAACTGGCTGGGG
TTGCGGCTACGATCTATGCA -> TGCGGCTACGATCTATGCAC
CTTGCCTTGGAGATACTTGT -> TTGCCTTGGAGATACTTGTC
TAACATGCTATATTGGTATA -> AACATGCTATATTGGTATAT
CGAATCCACAATTTTAACAT -> GAATCCACAATTTTAACATG
TGGAACAGCGACCATCCCGT -> GGAACAGCGACCATCCCGTT
GGGATTGGTACTAGCCCACC -> GGATTGGTACTAGCCCACCT
TGCACTTGAAACTGCCAACA -> GCACTTGAAACTGCCAACAC
GACCAGTAAAACCTAGGCGG -> ACCAGTAAAACCTAGGCGGG
TTGGTATATCTTTTTAATTA -> TGGTATATCTTTTTAATTAC
ATTCTCCATGTCCGGGTTTT -> TTCTCCATGTCCGGGTTTTG
CTTCGTCGAGCCTTCATCAG -> TTCGTCGAGCCTTCATCAGA
AGCCTTGCCTTGGAGATACT -> GCCTTGCCTTGGAGATACTT
AACGCAACCTGCGTCACTCA -> ACGCAACCTGCGTCACTCAG
TAGGGTTGTACGAGAGTGTG -> AGGGTTGTACGAGAGTGTGT
GTGGAGTGCTGGTAAGTCTG -> TGGAGTGCTGGTAAGTCTGA
GGGTTTTGTCCTCCTCCTAC -> GGTTTTGTCCTCCTCCTACC
CCAGGGTCCTCTACGTATAC -> CAGGGTCCTCTACGTATACG
ACCATATGGGATTGGTACTA -> CCATATGGGATTGGTACTAG
TACTTCTCACACTTTTGCAC -> ACTTCTCACACTTTTGCACC
TAGACATACACCCCTCTGAT -> AGACATACACCCCTCTGATA
TGGTAAGTCTGACACTAATC -> GGTAAGTCTGACACTAATCC
TTTGCATTCTGTCGAGTATT -> TTGCATTCTGTCGAGTATTG
CTCGATGGGTTATTAACAGG -> TCGATGGGTTATTAACAGGG
CTATCCTTGTGGAGTTTTCA -> TATCCTTGTGGAGTTTTCAT
AGGGTTGTACGAGAGTGTGT -> GGGTTGTACGAGAGTGTGTC
CAACTCGATGGGTTATTAAC -> AACTCGATGGGTTATTAACA
CTCGATCCCGATAACTCTTC -> TCGATCCCGATAACTCTTCT
CCGTGCCGGAAATGGCCATC -> CGTGCCGGAAATGGCCATCA
GTCCTCTACGTATACGAGTT -> TCCTCTACGTATACGAGTTG
GTCCCGCCTGTGATAGGTAA -> TCCCGCCTGTGATAGGTAAT
AGAGCTCGATCCCGATAACT -> GAGCTCGATCCCGATAACTC
CGATCTGAGTCTTCCAGCTC -> GATCTGAGTCTTCCAGCTCT
TACACCCCTCTGATAGCCCT -> ACACCCCTCTGATAGCCCTT
GCTATTCTCCATGTCCGGGT -> CTATTCTCCATGTCCGGGTT
GCGTCACTCAGGCGACGAGC -> CGTCACTCAGGCGACGAGCG
CAAGCCAGGGTCCTCTACGT -> AAGCCAGGGTCCTCTACGTA
CAGTAAAACCTAGGCGGGAG -> AGTAAAACCTAGGCGGGAGG
CACCCGAGCGGTACGAAGTT -> ACCCGAGCGGTACGAAGTTC
CGGGGACGCCTTGTGAAGCA -> GGGGACGCCTTGTGAAGCAT
TCAGAGTGGTCAAAGGGGTA -> CAGAGTGGTCAAAGGGGTAA
TATATCTTTTTAATTACTTC -> ATATCTTTTTAATTACTTCT
AGATTAGACGGGCGGGGACG -> GATTAGACGGGCGGGGACGC
TCGCACTTCGTCGAGCCTTC -> CGCACTTCGTCGAGCCTTCA
TGCGGGAAGGCTATTCTCCA -> GCGGGAAGGCTATTCTCCAT
ACTTCATAAGTTGTACTTAC -> CTTCATAAGTTGTACTTACA
ACCGTGCCGGAAATGGCCAT -> CCGTGCCGGAAATGGCCATC
GAAATGGCCATCACGCTGGA -> AAATGGCCATCACGCTGGAT
GATTGGTACTAGCCCACCTT -> ATTGGTACTAGCCCACCTTA
TGATAGGTAATGGAACAGCG -> GATAGGTAATGGAACAGCGA
TTGCCTTGGAGATACTTGTC -> TGCCTTGGAGATACTTGTCA
GTAAGCCCCAACTGCAGGAA -> TAAGCCCCAACTGCAGGAAT
TATTCTCCATGTCCGGGTTT -> ATTCTCCATGTCCGGGTTTT
GGACGCCTTGTGAAGCATAT -> GACGCCTTGTGAAGCATATA
TTGTGAAGCATATACCTCCC -> TGTGAAGCATATACCTCCCC
GGAGTGCTGGTAAGTCTGAC -> GAGTGCTGGTAAGTCTGACA
CTTGCGGCTACGATCTATGC -> TTGCGGCTACGATCTATGCA
CTGACACTAATCCTAACATA -> TGACACTAATCCTAACATAC
AACCTGCGTCACTCAGGCGA -> ACCTGCGTCACTCAGGCGAC
GGTACTAGCCCACCTTATAC -> GTACTAGCCCACCTTATACC
TTCCGACCATATGGGATTGG -> TCCGACCATATGGGATTGGT
ATGCTATATTGGTATATCTT -> TGCTATATTGGTATATCTTT
TAGCCTTGCCTTGGAGATAC -> AGCCTTGCCTTGGAGATACT
TTCTCTTCGTGTGGAGTGCT -> TCTCTTCGTGTGGAGTGCTG
AGCTCGATCCCGATAACTCT -> GCTCGATCCCGATAACTCTT
GAGTGCTGGTAAGTCTGACA -> AGTGCTGGTAAGTCTGACAC
ACTTGTCATTTCCATCATGA -> CTTGTCATTTCCATCATGAA
TGTCCTCCTCCTACCTCGCA -> GTCCTCCTCCTACCTCGCAC
GACGGGCGGGGACGCCTTGT -> ACGGGCGGGGACGCCTTGTG
CTCAGGCGACGAGCGAATCC -> TCAGGCGACGAGCGAATCCA
TCTGACACTAATCCTAACAT -> CTGACACTAATCCTAACATA
TGAGACTTCTGACACGACCT -> GAGACTTCTGACACGACCTA
CGAGCGAATCCACAATTTTA -> GAGCGAATCCACAATTTTAA
TTCGACTCGCCTAGGCTCTC -> TCGACTCGCCTAGGCTCTCG
ATAACTCTTCTTAAAAAGAT -> TAACTCTTCTTAAAAAGATT
TTTGCACCCGAGCGGTACGA -> TTGCACCCGAGCGGTACGAA
ATCAGAGTGGTCAAAGGGGT -> TCAGAGTGGTCAAAGGGGTA
CTTGTGAAGCATATACCTCC -> TTGTGAAGCATATACCTCCC
GCTCGGGTGACACCTTCTCT -> CTCGGGTGACACCTTCTCTT
TGGCTGGGGAGTCCTGCATA -> GGCTGGGGAGTCCTGCATAA
CACGAATATGCGGAGAGAGC -> ACGAATATGCGGAGAGAGCT
TGTCATGAATATGCCGCTTG -> GTCATGAATATGCCGCTTGC
GATTAGATTAGACGGGCGGG -> ATTAGATTAGACGGGCGGGG
CCCCGTAGGGTTGTACGAGA -> CCCGTAGGGTTGTACGAGAG
CCAACTGCAGGAATCGTATA -> CAACTGCAGGAATCGTATAC
TCCATCATGAATGATGTTTT -> CCATCATGAATGATGTTTTG
ATTGGTACTAGCCCACCTTA -> TTGGTACTAGCCCACCTTAT
GACCATATGGGATTGGTACT -> ACCATATGGGATTGGTACTA
GACCTATCCTTGTGGAGTTT -> ACCTATCCTTGTGGAGTTTT
TCGATCTGAGTCTTCCAGCT -> CGATCTGAGTCTTCCAGCTC
TAGGCTCTCGGTCCGCTTGA -> AGGCTCTCGGTCCGCTTGAG
CGATAACTCTTCTTAAAAAG -> GATAACTCTTCTTAAAAAGA
GACCTTTTACGAGACCAGTA -> ACCTTTTACGAGACCAGTAA
TACTTGTCATTTCCATCATG -> ACTTGTCATTTCCATCATGA
TCGATCCCGATAACTCTTCT -> CGATCCCGATAACTCTTCTT
TTGCATTCTGTCGAGTATTG -> TGCATTCTGTCGAGTATTGC
AATGGCCATCACGCTGGATA -> ATGGCCATCACGCTGGATAT
AGATACTTGTCATTTCCATC -> GATACTTGTCATTTCCATCA
TTGTACTTACAAGCCAGGGT -> TGTACTTACAAGCCAGGGTC
TAAAAAGATTTGTCATGAAT -> AAAAAGATTTGTCATGAATA
AAGCCAGGGTCCTCTACGTA -> AGCCAGGGTCCTCTACGTAT
GCTCTTGCGGCTACGATCTA -> CTCTTGCGGCTACGATCTAT
CGGGTGACACCTTCTCTTCG -> GGGTGACACCTTCTCTTCGT
TGGAGATACTTGTCATTTCC -> GGAGATACTTGTCATTTCCA
GTATTGCCTGAGCCGCCTTT -> TATTGCCTGAGCCGCCTTTG
TATACCTCCCCTTGCTCCTT -> ATACCTCCCCTTGCTCCTTC
TCTTCGTGTGGAGTGCTGGT -> CTTCGTGTGGAGTGCTGGTA
TTAATTACTTCTCACACTTT -> TAATTACTTCTCACACTTTT
CCATGTCCGGGTTTTGTCCT -> CATGTCCGGGTTTTGTCCTC
ACGAGTTGTTCTGTAAGCCC -> CGAGTTGTTCTGTAAGCCCC
GTGGAGTTTTCATCCAACTC -> TGGAGTTTTCATCCAACTCG
CTTATACCCCGCATACCTAG -> TTATACCCCGCATACCTAGC
ACTTCTCACACTTTTGCACC -> CTTCTCACACTTTTGCACCC
CATGAATGATGTTTTGCATT -> ATGAATGATGTTTTGCATTC
CTAGGCTCTCGGTCCGCTTG -> TAGGCTCTCGGTCCGCTTGA
TCCGCTTGAGACTTCTGACA -> CCGCTTGAGACTTCTGACAC
GTCGAGCCTTCATCAGAGTG -> TCGAGCCTTCATCAGAGTGG
CATCCCTAACTGGCTGGGGA -> ATCCCTAACTGGCTGGGGAG
GGCGAGCCGAGGATTAGATT -> GCGAGCCGAGGATTAGATTA
GGAGAGAGCTCGATCCCGAT -> GAGAGAGCTCGATCCCGATA
TCCGGGTTTTGTCCTCCTCC -> CCGGGTTTTGTCCTCCTCCT
TCCCGCCTGTGATAGGTAAT -> CCCGCCTGTGATAGGTAATG
ACCTATCCTTGTGGAGTTTT -> CCTATCCTTGTGGAGTTTTC
GGTTATTAACAGGGCCCCCC -> GTTATTAACAGGGCCCCCCG
GCAACTCGCTTGACCTTTTA -> CAACTCGCTTGACCTTTTAC
GAATATGCGGAGAGAGCTCG -> AATATGCGGAGAGAGCTCGA
TAGGTAATGGAACAGCGACC -> AGGTAATGGAACAGCGACCA
CATTTCCATCATGAATGATG -> ATTTCCATCATGAATGATGT
CCATCATGAATGATGTTTTG -> CATCATGAATGATGTTTTGC
AATGGAACAGCGACCATCCC -> ATGGAACAGCGACCATCCCG
ATGAATGATGTTTTGCATTC -> TGAATGATGTTTTGCATTCT
ACACGACCTATCCTTGTGGA -> CACGACCTATCCTTGTGGAG
TAATGGAACAGCGACCATCC -> AATGGAACAGCGACCATCCC
AGTTTTCATCCAACTCGATG -> GTTTTCATCCAACTCGATGG
ATCATGAATGATGTTTTGCA -> TCATGAATGATGTTTTGCAT
TTGTCATTTCCATCATGAAT -> TGTCATTTCCATCATGAATG
TTGAAACTGCCAACACTTCA -> TGAAACTGCCAACACTTCAT
ACACTTTTGCACCCGAGCGG -> CACTTTTGCACCCGAGCGGT
CGACGAGCGAATCCACAATT -> GACGAGCGAATCCACAATTT
CCTTTGGGCGCAACTCGCTT -> CTTTGGGCGCAACTCGCTTG
CATATGGGATTGGTACTAGC -> ATATGGGATTGGTACTAGCC
AGGGGTAAGAGGAAGCCGTG -> GGGGTAAGAGGAAGCCGTGG
CTTGAAACTGCCAACACTTC -> TTGAAACTGCCAACACTTCA
AGAGTGGTCAAAGGGGTAAG -> GAGTGGTCAAAGGGGTAAGA
TTAAAAAGATTTGTCATGAA -> TAAAAAGATTTGTCATGAAT
TTGTCCTCCTCCTACCTCGC -> TGTCCTCCTCCTACCTCGCA
TCTACGTATACGAGTTGTTC -> CTACGTATACGAGTTGTTCT
GAGCCGCCTTTGGGCGCAAC -> AGCCGCCTTTGGGCGCAACT
TAACAGGGCCCCCCGTAGGG -> AACAGGGCCCCCCGTAGGGT
AGCTCTTGCGGCTACGATCT -> GCTCTTGCGGCTACGATCTA
TATACGAGTTGTTCTGTAAG -> ATACGAGTTGTTCTGTAAGC
TGGGATTGGTACTAGCCCAC -> GGGATTGGTACTAGCCCACC
AAACTGCCAACACTTCATAA -> AACTGCCAACACTTCATAAG
ACCCCGCATACCTAGCCTTG -> CCCCGCATACCTAGCCTTGC
GCATAACGCAACCTGCGTCA -> CATAACGCAACCTGCGTCAC
TCGATGGGTTATTAACAGGG -> CGATGGGTTATTAACAGGGC
TTGCTCGGGTGACACCTTCT -> TGCTCGGGTGACACCTTCTC
GAGCTCGATCCCGATAACTC -> AGCTCGATCCCGATAACTCT
TCCCCTTGCTCCTTCCAGTG -> CCCCTTGCTCCTTCCAGTGC
GAGCGGTACGAAGTTCACGA -> AGCGGTACGAAGTTCACGAA
CCTCTACGTATACGAGTTGT -> CTCTACGTATACGAGTTGTT
CCTGCATAACGCAACCTGCG -> CTGCATAACGCAACCTGCGT
GGAGTTTTCATCCAACTCGA -> GAGTTTTCATCCAACTCGAT
TTGCCTGAGCCGCCTTTGGG -> TGCCTGAGCCGCCTTTGGGC
AGCCAGGGTCCTCTACGTAT -> GCCAGGGTCCTCTACGTATA
CACCTTATACCCCGCATACC -> ACCTTATACCCCGCATACCT
CATACCTAGCCTTGCCTTGG -> ATACCTAGCCTTGCCTTGGA
CATACCGTGCCGGAAATGGC -> ATACCGTGCCGGAAATGGCC
TAGACGGGCGGGGACGCCTT -> AGACGGGCGGGGACGCCTTG
TCCCGATAACTCTTCTTAAA -> CCCGATAACTCTTCTTAAAA
TCGGGTGACACCTTCTCTTC -> CGGGTGACACCTTCTCTTCG
ATACCCCGCATACCTAGCCT -> TACCCCGCATACCTAGCCTT
CCAGCTCTTGCGGCTACGAT -> CAGCTCTTGCGGCTACGATC
GCTCTCGGTCCGCTTGAGAC -> CTCTCGGTCCGCTTGAGACT
TATTGGTATATCTTTTTAAT -> ATTGGTATATCTTTTTAATT
TACCGTGCCGGAAATGGCCA -> ACCGTGCCGGAAATGGCCAT
GGGAGGAACAATTCGACTCG -> GGAGGAACAATTCGACTCGC
TAGCCCACCTTATACCCCGC -> AGCCCACCTTATACCCCGCA
GGGCGCAACTCGCTTGACCT -> GGCGCAACTCGCTTGACCTT
GCCTGTGATAGGTAATGGAA -> CCTGTGATAGGTAATGGAAC
CAACCTGCGTCACTCAGGCG -> AACCTGCGTCACTCAGGCGA
CTTTGGGCGCAACTCGCTTG -> TTTGGGCGCAACTCGCTTGA
CCGAGGATTAGATTAGACGG -> CGAGGATTAGATTAGACGGG
TAAGTTGTACTTACAAGCCA -> AAGTTGTACTTACAAGCCAG
GAGTATTGCCTGAGCCGCCT -> AGTATTGCCTGAGCCGCCTT
TATGCACTTGAAACTGCCAA -> ATGCACTTGAAACTGCCAAC
CATGTCCGGGTTTTGTCCTC -> ATGTCCGGGTTTTGTCCTCC
AGATTTGTCATGAATATGCC -> GATTTGTCATGAATATGCCG
ACATACACCCCTCTGATAGC -> CATACACCCCTCTGATAGCC
ATAGGTAATGGAACAGCGAC -> TAGGTAATGGAACAGCGACC
CGCTTGCTCGGGTGACACCT -> GCTTGCTCGGGTGACACCTT
AACAGCGACCATCCCGTTAT -> ACAGCGACCATCCCGTTATC
CCGCTTGCTCGGGTGACACC -> CGCTTGCTCGGGTGACACCT
TTCGTGTGGAGTGCTGGTAA -> TCGTGTGGAGTGCTGGTAAG
TATGGGATTGGTACTAGCCC -> ATGGGATTGGTACTAGCCCA
TTACGAGACCAGTAAAACCT -> TACGAGACCAGTAAAACCTA
CTATGCACTTGAAACTGCCA -> TATGCACTTGAAACTGCCAA
ACGAGCGAATCCACAATTTT -> CGAGCGAATCCACAATTTTA
TTTTACGAGACCAGTAAAAC -> TTTACGAGACCAGTAAAACC
GGGGAGTCCTGCATAACGCA -> GGGAGTCCTGCATAACGCAA
TGAGCCGCCTTTGGGCGCAA -> GAGCCGCCTTTGGGCGCAAC
GCTCGATCCCGATAACTCTT -> CTCGATCCCGATAACTCTTC
CGATCCCGATAACTCTTCTT -> GATCCCGATAACTCTTCTTA
TCCTTCCAGTGCTCGCCGTT -> CCTTCCAGTGCTCGCCGTTC
GAAGTTCACGAATATGCGGA -> AAGTTCACGAATATGCGGAG
GCCATCACGCTGGATATAGA -> CCATCACGCTGGATATAGAC
CATAAGTTGTACTTACAAGC -> ATAAGTTGTACTTACAAGCC
GGTGGCGAGCCGAGGATTAG -> GTGGCGAGCCGAGGATTAGA
TGTACTTACAAGCCAGGGTC -> GTACTTACAAGCCAGGGTCC
GTGTCCCGCCTGTGATAGGT -> TGTCCCGCCTGTGATAGGTA
CTCCATGTCCGGGTTTTGTC -> TCCATGTCCGGGTTTTGTCC
CATAACGCAACCTGCGTCAC -> ATAACGCAACCTGCGTCACT
ACAGCGACCATCCCGTTATC -> CAGCGACCATCCCGTTATCG
GACATACACCCCTCTGATAG -> ACATACACCCCTCTGATAGC
ATCTGAGTCTTCCAGCTCTT -> TCTGAGTCTTCCAGCTCTTG
CCTTGGAGATACTTGTCATT -> CTTGGAGATACTTGTCATTT
GGAACAATTCGACTCGCCTA -> GAACAATTCGACTCGCCTAG
TTTGGGCGCAACTCGCTTGA -> TTGGGCGCAACTCGCTTGAC
CCTCGCACTTCGTCGAGCCT -> CTCGCACTTCGTCGAGCCTT
GATTAGACGGGCGGGGACGC -> ATTAGACGGGCGGGGACGCC
TAATTACTTCTCACACTTTT -> AATTACTTCTCACACTTTTG
ACCTGCGTCACTCAGGCGAC -> CCTGCGTCACTCAGGCGACG
CACACTTTTGCACCCGAGCG -> ACACTTTTGCACCCGAGCGG
CTCCTCCTACCTCGCACTTC -> TCCTCCTACCTCGCACTTCG
GTAAGTCTGACACTAATCCT -> TAAGTCTGACACTAATCCTA
TGGGGAGTCCTGCATAACGC -> GGGGAGTCCTGCATAACGCA
TCATTTCCATCATGAATGAT -> CATTTCCATCATGAATGATG
CTCCTACCTCGCACTTCGTC -> TCCTACCTCGCACTTCGTCG
CTCGGGTGACACCTTCTCTT -> TCGGGTGACACCTTCTCTTC
TACGAAGTTCACGAATATGC -> ACGAAGTTCACGAATATGCG
ATACTTGTCATTTCCATCAT -> TACTTGTCATTTCCATCATG
CATCATGAATGATGTTTTGC -> ATCATGAATGATGTTTTGCA
GACGAGCGAATCCACAATTT -> ACGAGCGAATCCACAATTTT
CCCGCCTGTGATAGGTAATG -> CCGCCTGTGATAGGTAATGG
TCTCTTCGTGTGGAGTGCTG -> CTCTTCGTGTGGAGTGCTGG
GAGCCGAGGATTAGATTAGA -> AGCCGAGGATTAGATTAGAC
ACGAGACCAGTAAAACCTAG -> CGAGACCAGTAAAACCTAGG
TGCATTCTGTCGAGTATTGC -> GCATTCTGTCGAGTATTGCC
CCGCCTGTGATAGGTAATGG -> CGCCTGTGATAGGTAATGGA
CCTTGTGAAGCATATACCTC -> CTTGTGAAGCATATACCTCC
TGGTCAAAGGGGTAAGAGGA -> GGTCAAAGGGGTAAGAGGAA
CCTAGCCTTGCCTTGGAGAT -> CTAGCCTTGCCTTGGAGATA
GCGACGAGCGAATCCACAAT -> CGACGAGCGAATCCACAATT
GGAGATACTTGTCATTTCCA -> GAGATACTTGTCATTTCCAT
GTATACGAGTTGTTCTGTAA -> TATACGAGTTGTTCTGTAAG
CCATCACGCTGGATATAGAC -> CATCACGCTGGATATAGACA
ATTAGACGGGCGGGGACGCC -> TTAGACGGGCGGGGACGCCT
ACCTTTTACGAGACCAGTAA -> CCTTTTACGAGACCAGTAAA
GTCATGAATATGCCGCTTGC -> TCATGAATATGCCGCTTGCT
TACCTCGCACTTCGTCGAGC -> ACCTCGCACTTCGTCGAGCC
GCCTTGGAGATACTTGTCAT -> CCTTGGAGATACTTGTCATT
CGCAACCTGCGTCACTCAGG -> GCAACCTGCGTCACTCAGGC
CGTATACGAGTTGTTCTGTA -> GTATACGAGTTGTTCTGTAA
CCGCCTTTGGGCGCAACTCG -> CGCCTTTGGGCGCAACTCGC
TTTCCATCATGAATGATGTT -> TTCCATCATGAATGATGTTT
CCTATCCTTGTGGAGTTTTC -> CTATCCTTGTGGAGTTTTCA
CGCACTTCGTCGAGCCTTCA -> GCACTTCGTCGAGCCTTCAT
CTGGATATAGACATACACCC -> TGGATATAGACATACACCCC
GCACTTGAAACTGCCAACAC -> CACTTGAAACTGCCAACACT
CCAGTGCTCGCCGTTCCTTT -> CAGTGCTCGCCGTTCCTTTC
GGAGGAACAATTCGACTCGC -> GAGGAACAATTCGACTCGCC
AAGCCCCAACTGCAGGAATC -> AGCCCCAACTGCAGGAATCG
AGGCTATTCTCCATGTCCGG -> GGCTATTCTCCATGTCCGGG
TTGTCATGAATATGCCGCTT -> TGTCATGAATATGCCGCTTG
GTTTTGCATTCTGTCGAGTA -> TTTTGCATTCTGTCGAGTAT
AAGCCGTGGTGGCGAGCCGA -> AGCCGTGGTGGCGAGCCGAG
GTCCTCCTCCTACCTCGCAC -> TCCTCCTCCTACCTCGCACT
AGCATATACCTCCCCTTGCT -> GCATATACCTCCCCTTGCTC
AGCCGCCTTTGGGCGCAACT -> GCCGCCTTTGGGCGCAACTC
GAGGAAGCCGTGGTGGCGAG -> AGGAAGCCGTGGTGGCGAGC
CCGTTATCGATCTGAGTCTT -> CGTTATCGATCTGAGTCTTC
GGATATAGACATACACCCCT -> GATATAGACATACACCCCTC
TATGCGGAGAGAGCTCGATC -> ATGCGGAGAGAGCTCGATCC
CTTACAAGCCAGGGTCCTCT -> TTACAAGCCAGGGTCCTCTA
TTGGTACTAGCCCACCTTAT -> TGGTACTAGCCCACCTTATA
TACCTCCCCTTGCTCCTTCC -> ACCTCCCCTTGCTCCTTCCA
AATATGCCGCTTGCTCGGGT -> ATATGCCGCTTGCTCGGGTG
GTATACATCCCTAACTGGCT -> TATACATCCCTAACTGGCTG
AAGGCTATTCTCCATGTCCG -> AGGCTATTCTCCATGTCCGG
CGGCTACGATCTATGCACTT -> GGCTACGATCTATGCACTTG
AAAACCTAGGCGGGAGGAAC -> AAACCTAGGCGGGAGGAACA
CTGAGCCGCCTTTGGGCGCA -> TGAGCCGCCTTTGGGCGCAA
ATGGAACAGCGACCATCCCG -> TGGAACAGCGACCATCCCGT
CCTAACTGGCTGGGGAGTCC -> CTAACTGGCTGGGGAGTCCT
GATGTTTTGCATTCTGTCGA -> ATGTTTTGCATTCTGTCGAG
CCTAGGCTCTCGGTCCGCTT -> CTAGGCTCTCGGTCCGCTTG
CCTTGCTCCTTCCAGTGCTC -> CTTGCTCCTTCCAGTGCTCG
CAGAGTGGTCAAAGGGGTAA -> AGAGTGGTCAAAGGGGTAAG
CAGGGCCCCCCGTAGGGTTG -> AGGGCCCCCCGTAGGGTTGT
GCGGTACGAAGTTCACGAAT -> CGGTACGAAGTTCACGAATA
CACCCCTCTGATAGCCCTTA -> ACCCCTCTGATAGCCCTTAC
CTGCCAACACTTCATAAGTT -> TGCCAACACTTCATAAGTTG
CCAGTAAAACCTAGGCGGGA -> CAGTAAAACCTAGGCGGGAG
TTCCAGTGCTCGCCGTTCCT -> TCCAGTGCTCGCCGTTCCTT
TAAGAGGAAGCCGTGGTGGC -> AAGAGGAAGCCGTGGTGGCG
TCCTCCTCCTACCTCGCACT -> CCTCCTCCTACCTCGCACTT
GTCACTCAGGCGACGAGCGA -> TCACTCAGGCGACGAGCGAA
AGTTCACGAATATGCGGAGA -> GTTCACGAATATGCGGAGAG
TAACATACCGTGCCGGAAAT -> AACATACCGTGCCGGAAATG
TGCACCCGAGCGGTACGAAG -> GCACCCGAGCGGTACGAAGT
CCCGAGCGGTACGAAGTTCA -> CCGAGCGGTACGAAGTTCAC
AGTGCTGGTAAGTCTGACAC -> GTGCTGGTAAGTCTGACACT
CCTTATACCCCGCATACCTA -> CTTATACCCCGCATACCTAG
ACTAGCCCACCTTATACCCC -> CTAGCCCACCTTATACCCCG
CACTTGAAACTGCCAACACT -> ACTTGAAACTGCCAACACTT
AAATGGCCATCACGCTGGAT -> AATGGCCATCACGCTGGATA
AACTGCAGGAATCGTATACA -> ACTGCAGGAATCGTATACAT
CTTCGTGTGGAGTGCTGGTA -> TTCGTGTGGAGTGCTGGTAA
TGTAAGCCCCAACTGCAGGA -> GTAAGCCCCAACTGCAGGAA
AGGTAATGGAACAGCGACCA -> GGTAATGGAACAGCGACCAT
CGAGCGGTACGAAGTTCACG -> GAGCGGTACGAAGTTCACGA
ACGAATATGCGGAGAGAGCT -> CGAATATGCGGAGAGAGCTC
TTTCCGACCATATGGGATTG -> TTCCGACCATATGGGATTGG
ATATCTTTTTAATTACTTCT -> TATCTTTTTAATTACTTCTC
ACCTTCTCTTCGTGTGGAGT -> CCTTCTCTTCGTGTGGAGTG
TGGAGTTTTCATCCAACTCG -> GGAGTTTTCATCCAACTCGA
TGGTATATCTTTTTAATTAC -> GGTATATCTTTTTAATTACT
TGTACGAGAGTGTGTCCCGC -> GTACGAGAGTGTGTCCCGCC
GGGAGTCCTGCATAACGCAA -> GGAGTCCTGCATAACGCAAC
ACGTATACGAGTTGTTCTGT -> CGTATACGAGTTGTTCTGTA
GGGACGCCTTGTGAAGCATA -> GGACGCCTTGTGAAGCATAT
ATATAGACATACACCCCTCT -> TATAGACATACACCCCTCTG
ACCTAGGCGGGAGGAACAAT -> CCTAGGCGGGAGGAACAATT
TTATACCCCGCATACCTAGC -> TATACCCCGCATACCTAGCC
CATCCCGTTATCGATCTGAG -> ATCCCGTTATCGATCTGAGT
TACCCCGCATACCTAGCCTT -> ACCCCGCATACCTAGCCTTG
GAGAGTGTGTCCCGCCTGTG -> AGAGTGTGTCCCGCCTGTGA
GGTCCTCTACGTATACGAGT -> GTCCTCTACGTATACGAGTT
GAGCCTTCATCAGAGTGGTC -> AGCCTTCATCAGAGTGGTCA
CATACACCCCTCTGATAGCC -> ATACACCCCTCTGATAGCCC
CGGTCCGCTTGAGACTTCTG -> GGTCCGCTTGAGACTTCTGA
GTATATCTTTTTAATTACTT -> TATATCTTTTTAATTACTTC
AGCCCACCTTATACCCCGCA -> GCCCACCTTATACCCCGCAT
GGAAATGGCCATCACGCTGG -> GAAATGGCCATCACGCTGGA
CCTACCTCGCACTTCGTCGA -> CTACCTCGCACTTCGTCGAG
CTTGCTCGGGTGACACCTTC -> TTGCTCGGGTGACACCTTCT
TATGCCGCTTGCTCGGGTGA -> ATGCCGCTTGCTCGGGTGAC
TGCCGGAAATGGCCATCACG -> GCCGGAAATGGCCATCACGC
TTGTTCTGTAAGCCCCAACT -> TGTTCTGTAAGCCCCAACTG
TACGATCTATGCACTTGAAA -> ACGATCTATGCACTTGAAAC
TTCCTTTCCGACCATATGGG -> TCCTTTCCGACCATATGGGA
TGTCCCGCCTGTGATAGGTA -> GTCCCGCCTGTGATAGGTAA
GTCTGACACTAATCCTAACA -> TCTGACACTAATCCTAACAT
TTTTGCACCCGAGCGGTACG -> TTTGCACCCGAGCGGTACGA
GGGTGACACCTTCTCTTCGT -> GGTGACACCTTCTCTTCGTG
ATTTGTCATGAATATGCCGC -> TTTGTCATGAATATGCCGCT
CGCCTTTGGGCGCAACTCGC -> GCCTTTGGGCGCAACTCGCT
ATCTTTTTAATTACTTCTCA -> TCTTTTTAATTACTTCTCAC
CATTCTGTCGAGTATTGCCT -> ATTCTGTCGAGTATTGCCTG
TAAAACCTAGGCGGGAGGAA -> AAAACCTAGGCGGGAGGAAC
GCTTGAGACTTCTGACACGA -> CTTGAGACTTCTGACACGAC
GTTTTCATCCAACTCGATGG -> TTTTCATCCAACTCGATGGG
AATTTTAACATGCTATATTG -> ATTTTAACATGCTATATTGG
TTTTAATTACTTCTCACACT -> TTTAATTACTTCTCACACTT
CGTGCCGGAAATGGCCATCA -> GTGCCGGAAATGGCCATCAC
AACTCGATGGGTTATTAACA -> ACTCGATGGGTTATTAACAG
TGGATATAGACATACACCCC -> GGATATAGACATACACCCCT
CGGGCGGGGACGCCTTGTGA -> GGGCGGGGACGCCTTGTGAA
AGCCCCAACTGCAGGAATCG -> GCCCCAACTGCAGGAATCGT
TCGCCTAGGCTCTCGGTCCG -> CGCCTAGGCTCTCGGTCCGC
TCAGGCGACGAGCGAATCCA -> CAGGCGACGAGCGAATCCAC
TGAATGATGTTTTGCATTCT -> GAATGATGTTTTGCATTCTG
GCATATACCTCCCCTTGCTC -> CATATACCTCCCCTTGCTCC
GGTAAGTCTGACACTAATCC -> GTAAGTCTGACACTAATCCT
TGCCGCTTGCTCGGGTGACA -> GCCGCTTGCTCGGGTGACAC
GCCGCCTTTGGGCGCAACTC -> CCGCCTTTGGGCGCAACTCG
TCAAAGGGGTAAGAGGAAGC -> CAAAGGGGTAAGAGGAAGCC
TGCGTCACTCAGGCGACGAG -> GCGTCACTCAGGCGACGAGC
